############
#OO  #     ###
#OO  # X  X  #
#OO  #X####  #
#OO    P ##  #
#OO  # #  X ##
###### ##X X #
  # X  X X X #
  #    #     #
  ############